################
#   C       ####
#            CC#
#  d          C#
#           ####
#              #
#              #
#XX   @    d   #
#             G#
#    d         #
#              #
#        d     #
#  d           #
#     s    d   #
#              #
################
