################
#   C   @   X  #
#   G   L   X  #
#           X  #
#              #
#              #
#              #
# CC       d   #
#             G#
#    s         #
#              #
#        d     #
#  d           #
#     s    d   #
#              #
################
