################
#X     #G#     #
#              #
#   C       @  #
#       d      #
#     s       V#
###          ###
#L     XX     G#
###          ###
#C             #
#              #
#   d     ss   #
#   d  V       #
#C            C#
#      X     CC#
################
