################
#X#   s        #
#       O O    #
# V    LL      #
#              #
#          V   #
#      @ G   LL#
#      LL      #
# CC        C  #
#              #
#     dd  GG   #
#  d          L#
# #      ###O  #
# OO     XX    #
#    CC        #
################
