################
#   C   @   XX #
#       L   X  #
#  d        #  #
#              #
#     d        #
#              #
#  d       d   #
#             G#
#    d         #
#              #
#        d     #
#  d           #
#     s    d   #
#              #
################
