################
#X#  GG@X      #
# #   LL       #
# #          # #
# #          # #
# #    S     # #
# #          # #
# #          # #
# #          # #
# #          # #
# #          # #
# #          # #
# #          # #
# ############ #
#              #
################
