################
#X#  GG@L      #
# #  L        s#
# #          s #
# #          s #
# #          # #
# #          # #
# #          # #
# #          # #
# #          # #
# #      X   # #
# #          # #
# #          # #
# ############ #
#              #
################
