################
#X#  GG@X      #
# #   LL      C#
# #   OOO    # #
# #   s      # #
# #    ss    # #
# #          # #
# #          # #
# #          # #
# #          # #
# #          # #
# #          # #
# #          # #
# ############ #
#              #
################
