################
#L     @       #
#      X      G#
#  ooo  ########
#              #
#            ss#
#  C        #ss#
#      C    #ss#
#XX         #ss#
#          L ss#
#      C     ss#
#            ss#
#  C        #dd#
#        ####dd#
#V C    C#ddddV#
################
